00000000000000000000
00000000000000000000
000000@@@@@@@@000000
000000@000000@000000
000000@000000@000000
000000@000x00@000000
000000@000000@000000
000000@@@@@@@@000000
00000000000000000000
00000000000000000000
00000000000000000000
00000000000000000000
00000000000000000000
00000000000000000000
00000000000000000000
00000000000000000000
00000000000000000000
00000000000000000000
00000000000000000000
00000000000000000000